111111111
1E0000001
1C00000C1
1P0000001
111111111