111111111
100000001
1C00000C1
1P00000E1
111111111