111111111
1010000E1
1C01000C1
1P0010001
111111111