111111111
1000000P1
1C00000C1
1E0000001
111111111