111111111
1E1C00001
101110101
100000101
1P00001C1
111111111