111111111
1E0000101
1000001C1
1P0000101
111111111