111111111
1E0000001
100000101
1P00001C1
111111111