111111111
1000000E1
1C00C00C1
1P0000001
111111111