1111111
1000011
0P00001
1C00E01
1111111