111111111
1P0000001
1E0000001
100000001
111111111