111111111
100000001
1C00000C1
10000E001
111111111