0111111
1000011
1P00001
1C00E01
1111111