1111111
100001
1P00001
1C00E01
1111111