1111111
1000011
1P00000
1C00E01
1111111