111111111
1C10000E1
110000001
1P0000001
111111111